R 1000 750
F 100,100,214

EA ./textures/cat4.xpm
NO ./textures/cat1.xpm
SO ./textures/cat2.xpm
WE ./textures/cat3.xpm


1221
11111111111      1112121
100000022101
11111011111
1111101111111111111111111111111111111111111111
101000000010001001100000000000000000000000010111111111111111111111111111111
1012000000100000110000000000000000010010001111111111111111111111111111111                     
111111010000000110000000000000000011000000000000000000000001000000111111
1000000000000001100000000001111110101111111111111111111110000111101
1111110000000001100000010000000000100001100000100000000000000000001
10020010200000011000000000000100001011000000001111111111111111111111
1000000000011111111100000W00000010000000000010110000000001
100000102000000110000000000000000010110000000111111111111
111111000000000110000000000000010010000000001
1100011100000000000000021111110000010000000001111111      
1000000000000000110000000011211000000000100000000002
1000000000000001100010000001111001100000100000000001111111
1000000000000001100000000100000000010010000001111111
100000000000000011000000000000000001000000001
10000000000000011000000000000000001000000001
1111111111111111111111111111111111111111111
