R 800 600

NO ./pics/lisa.xpm

SO ./pics/van2.xpm

WE ./pics/ren.xpm

EA ./pics/tri.xpm

S ./pics/pillar.xpm

F                139,        69,                    19

C 135,206,235

11111111111111111111111111111111111
100000000000020002000000000000000011
10000000000002000200000000000000001
10000000000002000200000000000000001
10000000000002000200000000000000001
10000000000002000200000000000000001
10000000000002000200000000000000001
10000000000002000200000000000000001
10000000000002000200000000000000001
10000000000002000200000000000000001
10000000000002000200000000000000001
10000000000002000200000000000000001
10000000000002000200000000000000001
10000000000000000000000000000000001
10000000000000000000000000000000001
10000000000000000000000000000000001
10000000000000000000000000000000001
10000000000000000000000000000000001
10000000000000000000000000000000001
10000000000000000000000000000000001
10000000000000000000000000000000001
10000000000000000000000000000000001
10000000000000000000000000000000001
10000000000000000000000000000000001
10000000000000000000000000000000001
10000000000000000000000000000000001
10000000000000000000000000000000001
10000000000000000000000000000000001
10000000000000000000000000000000001
10000000000000000000000000000000001
10000000000000000000000000000000001
10000000000000000000000000000000001
10000000000000000000000000000000001
10000000000000000000000000000000001
10000000000000000000000000000000001
10000000000000000000000000000000001
10000000000000000000000000000000001
10000000000000000000000000000000001
10000000000000000001111111111000001
10000000000020000000222222222222201
100000002000200000111110N0000000001
10000100000020000010000002000200001
10001000000020000011000000200200001
10000002000220002020200201001101111
10000000000220000111111111111111111111
10002000000020000211000200000002000021
10000000000020000011000200000002000021
10000000000020000011000200000002000021
10000000000020000011000200000002000021
1111111111111111111111111111111111111111