R 800 600

NO ./pics/lisa.xpm

SO ./pics/van2.xpm

WE ./pics/ren.xpm

EA ./pics/tri.xpm

S ./pics/pillar.xpm

F                139,        69,                    19

C 135,206,235
     
11111111111111111111
10000000000000000001
10000000000000000001
10000000000020000001111
10000000200020000011111
1000010000002000001
10001000000020000011111
1000000000022000011
1000200000002000021
1000000000002000001
1000000000002000001
10000000000020000N1
1111111111111111111