R 600 400

NO ./greystone.xpm
SO ./bluestone.xpm
WE ./redbrick.xpm
EA ./mossy.xpm

S ./mossy.xpm

F 220,10,0

C 250,100,0

1111111111111111111
1000000000000000001
1000011111111111111
1000000000000000001
10000000000000000011111
1000000000000000001
100E0000000000000011111
1000000000000000001
1000000000000000001
1000000000000000001
1000000000000000001
1000000000000000001
1111111111111111111