R 600 400

NO ./path_to_the_north_texture
SO ./path_to_the_south_texture
WE ./path_to_the_west_texture
EA ./path_to_the_east_texture

F 220,100,0

C 250,100,0
        1111111111111111111111111
        10000000000100000000000001
        10001000000E00000000100001
        100010000000000000010000001
        111111111111111111111111111
